122222282222222222822222222222222222822222228222222222222222222222222222222222222222222222222223
112282222822222222222222222222222282222222222882222222222222228222222822222222222222222222222236
140000000000000000000000000000000000000000000000000000000000000000000000000000000000000000000066
140000000000000000000000000000000000000000000000000000000000000000000000000000000000000000000066
140000000000000000000000000000000000000000000000000000000000000000000000000000000000000000000066
140000000000000000000000000000000000000000000000000000000000000000000000000000000000000000000066
140000000000000000000000000000000000000000000000000000000000000000000000000000000000000000000066
140000000000000000000000000000000000000000000000000000000000000000000000000000000000000000000066
140000000000000000000000000000000000000000000000000000000000000000000000000000000000000000000066
440000000000000000000000000000000000000000000000000000000000000000000000000000000000000000000066
440000000000000000000000000000000000000000000000000000000000000000000000000000000000000000000066
440000000000000000000000000000000000000000000000000000000000000000000000000000000000000000000066
440000000000000000000000000000000000000000000000000000000000000000000000000000000000000000000066
440000000000000000000000000000000000000000000000000000000000000000000000000000000000000000000066
440000000000000000000000000005555555500000000000000000000000000000000000000000000000000000000066
640000000000000000000000000000000000000000000000000000000000000000000000000000000000000000000066
640000000000000000000000000000000000000000000000000000000000000000000000000000000000000000000066
640000000000000000000000000000000000000000000000000000000000000000000000000000000000000000000066
640000000000000000000000000000000000000000000000000000000000000000000000000000000000000000000066
640000000000000000000000000000000000000020000000000000000000000000000000000000000000000000000066
640000000000000000000000000000000000000022200000000000000000000000000000000000000000000000000066
640000000000000000000000000000000000000000022220000000000000000000000000000000000000000000000066
640000000000000000000008888888800000000000000002220000000000000000000000000000000000000000000066
440000000000000000000000000000800000000000000000002000000000000000000000000000000000000000000066
440000000000000000000000000000880000000000000000000220000000000000000000000000000000000000000066
440000000000000000000000000000080000000000000000000002000000000000000000000000000000000000000066
440000000000000000000000000000080000000000000000000000220000000000000000000000000000000000000066
440000000000000000000000000000008000000000000000000000022000000000000000000000000000000000000066
440000000000000000000000000000008880000000000000000000002200000000000000000000000000000000000066
440000000000000000000000000000000088888880000000000000000220000000000000000000000000000000000066
460000000000000000000000000000000000000000000000000000000022000000000000000000000000000000000066
460000000000000000000000000000000000000000000000000000000000222000000000000000000000000000000066
460000000000000000000000000000000000000000000000000000000000002200000000000000000000000000000066
460000000000000000000000000000000000000000000000000000000000000220000000000000000000000000000066
460000000000000000000000000000000000000000000000000000000000000022000000000000000000000000000066
460000000000000000000000000000000000000200000000000000000000000002000000000000000000000000000066
460000000000000000000000000000000000000022000000000000000000000000200000000000000000000000000066
460000000000000000000000000000000000000000200000000000000000000000000000000000000000000000000066
460000000000000000000000000000000000000000200000000000000000000000000000000000000000000000000066
460000000000000000000000400000000000000000022000000000000000000000000000000000000000000000000066
460000000000000000000000400000000000000000000220000000000000000000000000000000000000000000000066
440000000000000000000000400000000000000000000002000000000000000000000000000000000000000000000066
440000000000000000000000040000000000000000000000200000006000000000000000000000000000000000000066
440000000000000000000000004000000000000000000000020000006600000000000000000000000000000000000066
440000000000000000000000000444000000000000000000002000000066600000000000000000000000000000000046
440000000000000000000000000004000000000000000000002200000000066000000060000000000000000000000066
440000000000000000000000000004000000000000000000000020000000006600066660000000000000000000000066
440000000000000000000000000004000000000000000000000020000000000066606660000000000000000000000066
440000000000000000000000000000440000000000000000000022000000000006666660000000000000000000000066
440000000000000000000000000000004000000000000000000002000000000006666660000000000000000000000066
440000000000000000000000000000000400000000000000000000200000000000666600000000000000000000000046
440000000000000000000000000000000040000000000000000000200000000000066600000000000000000000000066
440000000000000000000000000000000004000000000000000000020000000000000000000000000000000000000066
440000000000000000000000000000000004000000000000000000002000000000000000000000000000000000000066
440000000000000000000000000000000004000000000000000000002000000000000000000000000000000000000066
440000000000000000000000000000000004400000000000000000000200000000000000000000000000000000000066
440000000000000000000000000000000000444000000000000000000020000000000000000000000000000000000066
440000000000000000000000000000000000000400000000000000000022000000000000000000000000000000000046
440000000000000000000000000000000000000000000000000000000000000000000000000000000000000000000066
440000000000000000000000000000000000000000000000000000000000000000000000000000000000000000000066
440000000000000000000000000000000000000000000000000000000000000000000000000000000000000000000046
440000000000000000000000000000000000000000000000000000000000000000000000000000000000000000000066
440000000000000000000000000000000000000000000000000000000000000000000000000000000000000000000066
440000000000000000000000000000000000000000000000000000000000000000000000000000000000000000000066
640000000000000000000000000000000000000000000000000000000000000000000000000000000000000000000066
640000000000000000000000000000000000000000000000000000000000000000000000000000000000000000000066
440000000000000000000000000000000000000000000000000000000000000000000000000000000000000000000066
440000000000000000000000000000000000000000000000000000000000000000000000000000000000000000000066
440000000000000000000000000000000000000000000000000000000000000000000000000000000000000000000066
440000000000000000000000000000000000000000000000000000000000000000000000000000000000000000000066
640000000000000000000000000000000000000000000000000000000000000000000000000000000000000000000066
460000000000000000000000000000000000000000000000000000000000000000000000000000000000000000000066
440000000000000000000000000000000000000000000000000000000000000000000000000000000000000000000066
440000000000000000000000000000000000000000000000000000000000000000000000000000000000000000000066
440000000000000000000000000000000000000000000000000000000000000000000000000000000000000000000066
440000000000000000000000000000000000000000000000000000000000000000000000000000000000000000000066
640000000000000000000000000000000000000000000000000000000000000000000000000000000000000000000066
440000000000000000000000000000000000000000000000000000000000000000000000000000000000000000000066
440000000000000000000000000000000000000000000000000000000000000000000000000000000000000000000066
460000000000000000000000000000000000000000000000000000000000000000000000000000000000000000000066
440000000000000000000000000000000000000000000000000000000000000000000000000000000000000000000066
440000000000000000000000000000000000000000000000000000000000000000000000000000000000000000000066
440000000000000000000000000000000000000000000000000000000000000000000000000000000000000000000066
440000000000000000000000000000000000000000000000000000000000000000000000000000000000000000000066
440000000000000000000000000000000000000000000000000000000000000000000000000000000000000000000066
440000000000000000000000000000000000000000000000000000000000000000000000000000000000000000000066
440000000000000000000000000000000000000000000000000000000000000000000000000000000000000000000066
440000000000000000000000000000000000000000000000000000000000000000000000000000000000000000000066
440000000000000000000000000000000000000000000000000000000000000000000000000000000000000000000066
460000000000000000000000000000000000000000000000000000000000000000000000000000000000000000000066
440000000000000000000000000000000000000000000000000000000000000000000000000000000000000000000066
640000000000000000000000000000000000000000000000000000000000000000000000000000000000000000000066
440000000000000000000000000000000000000000000000000000000000000000000000000000000000000000000066
440000000000000000000000000000000000000000000000000000000000000000000000000000000000000000000066
478888882888888882888828828888888888888888888888828888888888288888888888288888888828888828888896
788888888882888888888888888888828888888888888888888888888888888888888888888888888888888888888889