188888882888888888888882888828888888888288888883018888828888288888888888888888888888888888888883
613131318888882888888288888888828888888288888837891888888288888888888888828888888888288831313134
679797960000000000000000000000000000000000000060006000000000000000000000000000000000000067979794
613131890000000000000000000000000000000000000061836000000000000000000000000000000000000078313136
679796000000000000000000000000000000000000000067896000000000000000000000000000000000000000679796
613189000000000000000000000000000000000000000060006000000000000000000000000000000000000000783136
479600000000000000000000000000000000000000000061836000000000000000000000000000000000000000006796
618900000000000000000000000000000000000000000067896000000000000000000000000000000000000000007836
660000000000000000000000000000000000000000000060006000000000000000000000000000000000000000000046
660000000000000000000000000000000000000000000061836000000000000000000000000000000000000000000066
6600000000n00000000000000000000000000000000000678960000000000000000000000000000000000n0000000066
660000000000000000000000000000000000000000000060006000000000000000000000000000000000000000000066
660000000000000000000000000000000000000000000061836000000000000000000000000000000000000000000066
660000000000000000000000000000000000000000000067896000000000000000000000000000000000000000000064
660000000000000000000000000000000000000000000060006000000000000000000000000000000000000000000066
640000000000000000000000000000000000000000000061836000000000000000000000000000000000000000000066
660000000000000000000000000000000000000000000067896000000000000000000000000000000000000000000066
660000000000000018828830000000000000000000000060006000000000000000000000001882883000000000000066
660000000000000061288360000000000000000000000061836000000000000000000000006128836000000000000066
660000000000000066000660000000000000000000000067896000000000000000000000006600066000000000000066
660000000000000066000660000000000000000000000078889000000000000000000000006600066000000000000066
660000000000000067888960000000000000000000000000000000000000000000000000006788896000000000000066
660000000000000078301890000000000000000000000000000000000000000000000000007830189000000000000066
640000000000000000606000000000000000000000000000000000000000000000000000000060600000000000000066
660000000000000000606000000000000000000000000000000000000000000000000000000060600000000000000066
660000000000000000606000000000000000000000000000000000000000000000000000000060600000000000000066
660000000000000000606000000000000000000000000000000000000000000000000000000060600000000000000066
660000000000000000606000000018282883000000000000000000000000018882883000000060600000000000000066
660000000000000000606000000060000006000000000000000000000000060000006000000060600000000000000066
660000000000000000606000000060000006000000000000000000000000060000006000000060600000000000000046
460000000000000000606000000060013006000000000000000000000000040013006000000060600000000000000064
660000000000000000606000000060079004000000000000000000000000060079006000000060600000000000000066
660000000000000000606000000060000006000000000000000000000000060000004000000060600000000000000066
660000000000000000606000000060000006000000000000000000000000060000006000000060600000000000000066
660000000000000000606000000078888825288888300000000000188828858882889000000060400000000000000066
660000000000000000606000000000000006000000400000000000600000060000000000000040600000000000000066
660000000000000000606000000000000006000000600000000000600000060000000000000060600000000000000066
660000000000000000606000000000000006001300600000000000600130040000000000000060600000000000000066
660000000000000000606000000000000006007900400000000000600790060000000000000060600000000000000066
660000000000000000606000000000000006000000600000000000400000060000000000000060600000000000000046
660000000000000000606000000000000006000000600000000000600000060000000000000040600000000000000066
660000000000000000606000000000000007828888900000000000788828890000000000000060400000000000000066
660000000000000000606000000000000000000000000000000000000000000000000000000060600000000000000064
660000000000000000606000000000000000000000000000000000000000000000000000000060600000000000000066
660000000000000000606000000000000000000000000000000000000000000000000000000060600000000000000066
678888888888888888907888888883000000000000000000000000000000000000000000000040600000000000000066
600000000000000000000000000006000000000000000000000000000000000000018888888890788888888888888896
618888888888888888301888888889000000000000000000000000000000000000060000000000000000000000000006
640000000000000000606000000000000000000000000000000000000000000000078888888830188888888888888836
660000000000000000606000000000000000000000000000000000000000000000000000000060600000000000000066
660000000000000000606000000000000000000000000000000000000000000000000000000060600000000000000066
660000000000000000606000000000000000000000000000000000000000000000000000000060600000000000000066
460000000000000000606000000000000000000000000000000000000000000000000000000060400000000000000046
660000000000000000606000000000000001882828300000000000188828830000000000000040600000000000000066
660000000000000000606000000000000006000000600000000000600000060000000000000060600000000000000066
660000000000000000606000000000000004000000600000000000600000060000000000000060600000000000000066
660000000000000000606000000000000006001300600000000000600130060000000000000060600000000000000064
660000000000000000606000000000000004007900600000000000600790060000000000000040400000000000000066
660000000000000000606000000000000006000000400000000000600000060000000000000060600000000000000066
660000000000000000606000000000000006000000600000000000600000060000000000000060600000000000000066
660000000000000000606000000018282885882828900000000000782888858828283000000040600000000000000066
660000000000000000606000000040000006000000000000000000000000060000006000000060600000000000000066
660000000000000000606000000060000006000000000000000000000000060000006000000060600000000000000066
660000000000000000606000000060013004000000000000000000000000060013006000000040600000000000000066
660000000000000000606000000040079006000000000000000000000000060079006000000060600000000000000066
660000000000000000606000000060000006000000000000000000000000060000006000000060400000000000000066
660000000000000000404000000060000006000000000000000000000000060000006000000040400000000000000066
660000000000000000404000000078828889000000000000000000000000078888289000000040400000000000000066
660000000000000000606000000000000000000000000000000000000000000000000000000060600000000000000046
660000000000000000606000000000000000000000000000000000000000000000000000000060600000000000000066
660000000000000000606000000000000000000000000000000000000000000000000000000060600000000000000066
660000000000000000606000000000000000000000000000000000000000000000000000000060600000000000000046
660000000000000000404000000000000000000000000000000000000000000000000000000040400000000000000066
640000000000000018907830000000000000000000000000000000000000000000000000001890783000000000000066
660000000000000061288360000000000000000000000000000000000000000000000000006128836000000000000064
660000000000000066000660000000000000000000000018883000000000000000000000006600066000000000000066
460000000000000066000660000000000000000000000061836000000000000000000000006600066000000000000066
660000000000000067888960000000000000000000000067896000000000000000000000006788896000000000000046
660000000000000072288890000000000000000000000060006000000000000000000000007228889000000000000066
660000000000000000000000000000000000000000000061836000000000000000000000000000000000000000000064
660000000000000000000000000000000000000000000067896000000000000000000000000000000000000000000046
660000000000000000000000000000000000000000000060006000000000000000000000000000000000000000000066
660000000000000000000000000000000000000000000061836000000000000000000000000000000000000000000066
660000000000000000000000000000000000000000000067896000000000000000000000000000000000000000000066
660000000000000000000000000000000000000000000060006000000000000000000000000000000000000000000066
6600000000n00000000000000000000000000000000000618360000000000000000000000000000000000n0000000046
660000000000000000000000000000000000000000000067896000000000000000000000000000000000000000000066
660000000000000000000000000000000000000000000060006000000000000000000000000000000000000000000066
672300000000000000000000000000000000000000000061836000000000000000000000000000000000000000001296
613600000000000000000000000000000000000000000067896000000000000000000000000000000000000000006136
679783000000000000000000000000000000000000000060006000000000000000000000000000000000000000189794
613136000000000000000000000000000000000000000061836000000000000000000000000000000000000000613136
679797830000000000000000000000000000000000000067896000000000000000000000000000000000000012979796
613131360000000000000000000000000000000000000060006000000000000000000000000000000000000061313136
679797978888888882888888888888888288288888888891837888888888888888888888888288888888828897979794
788888288888882888888888882888888888882888888889078888882888882888882888888888882888888888882889